1111111111111111
1000000000000001
1011111111111101
1010010100010101
1010000000010101
1010010100010101
1011110111110101
1000000000010101
1011111111110101
1010001010010101
1010001010010101
1010000000010101
1010001010010101
1011111011110101
1000000000000101
1111111111111111