WWWWWWWW
WWWWWWWW
WWWWDWWW
WWW   WW
WWW   WW
WWWWWWWW
WWWWWWWW
WWWWWWWW