WWWWDWWW
WWWW WWW
WWWW WWW
WWWW WWW
WWWW WWW
WWWWWWWW
WWWWWWWW
WWWWWWWW