WDWWWWWW
W WWWWWW
W WWWWWW
W WWWWWW
W    WWW
WW WWWWW
WW   DWW
WWWWWWWW