WDWWWWWW
W W    W
W W WWWW
W W WWWW
W     WW
W WWWWWW
W      D
WWWWWWWW