WWWWWWDW
WWWWWW W
WWWWWW W
W    W W
W WW W W
W WWWW W
W      W
WWWWWWWW