WWWWWWWW
WWWWWWWW
WWWWWWWW
WWWWWWWW
WWWW   W
WWWWWW W
D      W
WWWWWWWW