WWWWWWWW
WWWWWWWW
WWWWWWWW
WWWWWWWW
WWWW   D
WWWW WWW
WWWW  WW
WWWWWDWW