WWWWDWWW
W    W D
W WW   W
W WWWW W
W      W
WWWWWWWW
WWWWWWWW
WWWWWWWW