WWWWWWWW
WWWWWWWW
WWWW WWW
WWWW WWW
WD     D
WWWW WWW
WWWW WWW
WWWWDWWW