WWWWWWWW
W     WW
W WW  DW
W WWWWWW
W WW   W
W WWWW W
W      W
WWWWWWWW